Mushroom 0.45 Butterfly 0.45 Ogre 0.1
4 4 4 4 4 4 4 2 2 2 4 4 4 4 4 4
4 1 1 1 0 0 0 0 0 0 0 0 0 1 1 4
4 1 0 0 0 0 0 0 0 0 0 0 0 0 1 4
4 1 0 1 0 0 0 0 0 0 0 0 0 1 0 4
4 0 0 0 0 0 0 0 0 0 0 0 0 0 0 4
4 0 0 0 0 0 0 0 0 0 0 0 0 0 0 4
4 0 0 0 0 0 0 0 0 0 0 0 0 0 0 4
2 0 0 0 0 0 0 0 0 0 0 0 0 0 0 2
2 0 0 0 0 0 0 0 0 0 0 0 0 0 0 2
2 0 0 0 0 0 0 0 0 0 0 0 0 0 0 2
4 0 0 0 0 0 0 0 0 0 0 0 0 0 0 4
4 0 0 0 0 0 0 0 0 0 0 0 0 0 0 4
4 0 0 1 0 0 0 0 0 0 0 0 0 1 0 4
4 1 0 0 0 0 0 0 0 0 0 0 1 1 1 4
4 1 1 1 0 0 0 0 0 0 0 0 0 1 1 4
4 4 4 4 4 4 4 2 2 2 4 4 4 4 4 4