Orc 0.925 SpikeBall 0.075
4 4 4 4 4 4 4 2 2 2 4 4 4 4 4 4
4 0 0 0 0 0 0 0 0 0 0 0 0 0 0 4
4 0 0 0 0 0 0 0 0 0 0 0 0 0 0 4
4 0 0 0 0 0 0 0 0 0 0 0 0 0 0 4
4 0 0 0 3 3 0 0 0 0 0 3 3 0 0 4
4 0 0 0 3 0 0 0 0 0 0 0 3 0 0 4
4 0 0 0 0 0 0 0 0 0 0 0 0 0 0 4
2 0 0 0 0 0 0 0 0 0 0 0 0 0 0 2
2 0 0 0 0 0 0 0 0 0 0 0 0 0 0 2
2 0 0 0 0 0 0 0 0 0 0 0 0 0 0 2
4 0 0 0 0 0 0 0 0 0 0 0 0 0 0 4
4 0 0 0 3 0 0 0 0 0 0 0 3 0 0 4
4 0 0 0 3 3 0 0 0 0 0 3 3 0 0 4
4 0 0 0 0 0 0 0 0 0 0 0 0 0 0 4
4 0 0 0 0 0 0 0 0 0 0 0 0 0 0 4
4 4 4 4 4 4 4 2 2 2 4 4 4 4 4 4