Mushroom 0.35 Butterfly 0.35 Ogre 0.3
4 4 4 4 4 4 4 2 2 2 4 4 4 4 4 4
4 0 0 0 0 0 0 0 0 0 0 0 0 0 0 4
4 0 0 0 0 0 0 0 0 0 0 0 0 0 0 4
4 0 1 0 0 0 0 0 0 0 0 1 0 0 0 4
4 0 0 1 0 0 0 0 0 0 0 0 0 0 0 4
4 0 0 0 0 0 0 0 0 0 0 0 0 0 0 4
4 0 0 0 0 0 0 0 0 0 1 0 0 0 0 4
2 0 0 0 0 0 0 0 0 0 0 0 0 0 0 2
2 0 0 0 0 0 0 0 0 0 3 0 0 0 0 2
2 0 0 0 0 3 0 0 0 0 1 0 0 0 0 2
4 0 0 0 0 0 0 0 0 0 0 0 1 0 0 4
4 0 0 0 0 0 0 0 0 0 0 0 0 0 0 4
4 0 0 3 0 0 0 0 0 0 3 0 1 0 0 4
4 0 0 0 0 0 0 0 0 0 0 0 0 0 0 4
4 0 0 0 0 0 0 0 0 0 0 0 0 0 0 4
4 4 4 4 4 4 4 2 2 2 4 4 4 4 4 4