Orc 0.8 SpikeBall 0.075 Ogre 0.425
4 4 4 4 4 4 4 2 2 2 4 4 4 4 4 4
4 4 4 0 0 0 0 0 0 0 0 0 0 4 4 4
4 4 0 0 0 0 0 0 0 0 0 0 0 0 4 4
4 0 0 0 0 0 0 0 0 0 0 0 0 0 0 4
4 0 0 0 0 0 0 0 3 0 0 0 0 0 0 4
4 0 0 0 0 0 0 0 0 0 0 0 0 0 0 4
4 0 0 0 0 0 0 0 0 0 0 0 0 0 0 4
2 0 0 0 0 0 0 0 0 0 0 0 0 0 0 2
2 0 0 0 3 0 0 0 0 0 0 0 3 0 0 2
2 0 0 0 0 0 0 0 0 0 0 0 0 0 0 2
4 0 0 0 0 0 0 0 0 0 0 0 0 0 0 4
4 0 0 0 0 0 0 0 0 0 0 0 0 0 0 4
4 0 0 0 0 0 0 0 3 0 0 0 0 0 0 4
4 4 0 0 0 0 0 0 0 0 0 0 0 0 4 4
4 4 4 0 0 0 0 0 0 0 0 0 0 4 4 4
4 4 4 4 4 4 4 2 2 2 4 4 4 4 4 4